"lang"
{
"Language"	"vietnamese"
"Tokens"
{
"addon_game_name"	"Nemestice"
"[english]addon_game_name"	"Nemestice"
"DOTA_GameMode_15"	"Nemestice"
"[english]DOTA_GameMode_15"	"Nemestice"
"DOTA_GameMode_19"	"Nemestice"
"[english]DOTA_GameMode_19"	"Nemestice"
"DOTA_HUD_Nemestice_Tower_Lost_Dire"	"Một trụ Dire đã đổ! <font color='#E99FB8'>{d:int_value}</font> trụ còn lại trở nên mạnh hơn!"
"[english]DOTA_HUD_Nemestice_Tower_Lost_Dire"	"A Dire Tower has fallen! The <font color='#E99FB8'>{d:int_value}</font> tower(s) remaining grow stronger!"
"DOTA_HUD_Nemestice_Tower_Lost_Radiant"	"Một trụ Radiant đã đổ! <font color='#E99FB8'>{d:int_value}</font> trụ còn lại trở nên mạnh hơn!"
"[english]DOTA_HUD_Nemestice_Tower_Lost_Radiant"	"A Radiant Tower has fallen! The <font color='#E99FB8'>{d:int_value}</font> tower(s) remaining grow stronger!"
"Nemestice_BattlePointsFound_DireFirstTower"	"Dire nhận <font color='#E99FB8'>{d:int_value}</font> điểm Battle do phá trụ đầu tiên!"
"[english]Nemestice_BattlePointsFound_DireFirstTower"	"The Dire earned <font color='#E99FB8'>{d:int_value}</font> Battle Points each for destroying the first tower!"
"Nemestice_BattlePointsFound_RadiantFirstTower"	"Radiant nhận <font color='#E99FB8'>{d:int_value}</font> điểm Battle do phá trụ đầu tiên!"
"[english]Nemestice_BattlePointsFound_RadiantFirstTower"	"The Radiant earned <font color='#E99FB8'>{d:int_value}</font> Battle Points each for destroying the first tower!"
"Nemestice_BattlePointsFound_RadiantMeteorStun"	"Radiant nhận <font color='#E99FB8'>{d:int_value}</font> điểm Battle nhờ bẫy một tướng địch dưới thiên thạch!"
"[english]Nemestice_BattlePointsFound_RadiantMeteorStun"	"The Radiant earned <font color='#E99FB8'>{d:int_value}</font> Battle Points each for trapping an enemy hero under a meteorite!"
"Nemestice_BattlePointsFound_DireMeteorStun"	"Dire nhận <font color='#E99FB8'>{d:int_value}</font> điểm Battle nhờ bẫy một tướng địch dưới thiên thạch!"
"[english]Nemestice_BattlePointsFound_DireMeteorStun"	"The Dire earned <font color='#E99FB8'>{d:int_value}</font> Battle Points each for trapping an enemy hero under a meteorite!"
"Nemestice_BattlePointsFound_RadiantShrineTeamfight"	"Radiant nhận <font color='#E99FB8'>{d:int_value}</font> điểm Battle nhờ dùng giếng để hỗ trợ giao tranh đội!"
"[english]Nemestice_BattlePointsFound_RadiantShrineTeamfight"	"The Radiant earned <font color='#E99FB8'>{d:int_value}</font> Battle Points each for using a Shrine to help in their teamfight!"
"Nemestice_BattlePointsFound_DireShrineTeamfight"	"Dire nhận <font color='#E99FB8'>{d:int_value}</font> điểm Battle nhờ dùng giếng để hỗ trợ giao tranh đội!"
"[english]Nemestice_BattlePointsFound_DireShrineTeamfight"	"The Dire earned <font color='#E99FB8'>{d:int_value}</font> Battle Points each for using a Shrine to help in their teamfight!"
"Nemestice_BattlePointsFound_RadiantNeutralSteal"	"Radiant nhận <font color='#E99FB8'>{d:int_value}</font> điểm Battle vì cướp được một trang bị rừng!"
"[english]Nemestice_BattlePointsFound_RadiantNeutralSteal"	"The Radiant earned <font color='#E99FB8'>{d:int_value}</font> Battle Points each for stealing a neutral item!"
"Nemestice_BattlePointsFound_DireNeutralSteal"	"Dire nhận <font color='#E99FB8'>{d:int_value}</font> điểm Battle vì cướp được một trang bị rừng!"
"[english]Nemestice_BattlePointsFound_DireNeutralSteal"	"The Dire earned <font color='#E99FB8'>{d:int_value}</font> Battle Points each for stealing a neutral item!"
"DOTA_HUD_Nemestice_TowerAnnouncement_RadiantTowerFallen"	"Trụ Radiant đã đổ..."
"[english]DOTA_HUD_Nemestice_TowerAnnouncement_RadiantTowerFallen"	"Radiant's Tower has fallen..."
"DOTA_HUD_Nemestice_TowerAnnouncement_DireTowerFallen"	"Trụ Dire đã đổ..."
"[english]DOTA_HUD_Nemestice_TowerAnnouncement_DireTowerFallen"	"Dire's Tower has fallen..."
"DOTA_HUD_Nemestice_TowerAnnouncement_TowersRemaining_Plural"	"Còn {d:towers_remaining} trụ"
"[english]DOTA_HUD_Nemestice_TowerAnnouncement_TowersRemaining_Plural"	"{d:towers_remaining} Towers Remain"
"DOTA_HUD_Nemestice_TowerAnnouncement_TowersRemaining_Singular"	"Còn {d:towers_remaining} trụ"
"[english]DOTA_HUD_Nemestice_TowerAnnouncement_TowersRemaining_Singular"	"{d:towers_remaining} Tower Remains"
"DOTA_HUD_Nemestice_TowerAnnouncement_Kobolds"	"Kobold cuồng Nemestice đã tham chiến"
"[english]DOTA_HUD_Nemestice_TowerAnnouncement_Kobolds"	"Nemestice-crazed Kobolds have joined the fight"
"DOTA_HUD_Nemestice_TowerAnnouncement_Priests"	"Mục Sư cuồng Nemestice đã tham chiến"
"[english]DOTA_HUD_Nemestice_TowerAnnouncement_Priests"	"Nemestice-crazed Priests have joined the fight"
"DOTA_HUD_Nemestice_TowerAnnouncement_Hellbears"	"Gấu Địa Ngục cuồng Nemestice đã tham chiến"
"[english]DOTA_HUD_Nemestice_TowerAnnouncement_Hellbears"	"Nemestice-crazed Hellbears have joined the fight"
"DOTA_HUD_Nemestice_Overtime"	"Bù giờ<br><span class=\"BoldMessageSmall\">+{d:extra_time} giây</span>"
"[english]DOTA_HUD_Nemestice_Overtime"	"Overtime<br><span class=\"BoldMessageSmall\">+{d:extra_time}s Added</span>"
"DOTA_HUD_Nemestice_SuddenDeath"	"Đột tử"
"[english]DOTA_HUD_Nemestice_SuddenDeath"	"Sudden Death"
"npc_dota_tower_radiant_top"	"Radiant 1"
"[english]npc_dota_tower_radiant_top"	"Radiant 1"
"npc_dota_tower_radiant_mid_back"	"Radiant 2"
"[english]npc_dota_tower_radiant_mid_back"	"Radiant 2"
"npc_dota_tower_radiant_mid_forward"	"Radiant 3"
"[english]npc_dota_tower_radiant_mid_forward"	"Radiant 3"
"npc_dota_tower_radiant_bot"	"Radiant 4"
"[english]npc_dota_tower_radiant_bot"	"Radiant 4"
"npc_dota_tower_dire_top"	"Dire 1"
"[english]npc_dota_tower_dire_top"	"Dire 1"
"npc_dota_tower_dire_mid_forward"	"Dire 2"
"[english]npc_dota_tower_dire_mid_forward"	"Dire 2"
"npc_dota_tower_dire_mid_back"	"Dire 3"
"[english]npc_dota_tower_dire_mid_back"	"Dire 3"
"npc_dota_tower_dire_bot"	"Dire 4"
"[english]npc_dota_tower_dire_bot"	"Dire 4"
"DOTA_HUD_Nemestice_TimeLeft1"	"1"
"[english]DOTA_HUD_Nemestice_TimeLeft1"	"1"
"DOTA_HUD_Nemestice_TimeLeft2"	"2"
"[english]DOTA_HUD_Nemestice_TimeLeft2"	"2"
"DOTA_HUD_Nemestice_TimeLeft3"	"3"
"[english]DOTA_HUD_Nemestice_TimeLeft3"	"3"
"DOTA_HUD_Nemestice_TimeLeft10"	"Còn 10 giây"
"[english]DOTA_HUD_Nemestice_TimeLeft10"	"10s Remaining"
"DOTA_HUD_Nemestice_TimeLeft20"	"Còn 20 giây"
"[english]DOTA_HUD_Nemestice_TimeLeft20"	"20s Remaining"
"DOTA_nemestice_gameplay_tips_count"	"MẸO {d:current_tip_num} / {d:num_tips}"
"[english]DOTA_nemestice_gameplay_tips_count"	"TIP {d:current_tip_num} / {d:num_tips}"
"DOTA_nemestice_gameplay_tips_text"	"{s:tip_text}"
"[english]DOTA_nemestice_gameplay_tips_text"	"{s:tip_text}"
"DOTA_nemestice_gameplay_tip_00"	"Khi một trụ bị phá hủy, toàn bộ trụ đồng minh còn lại sẽ được nâng cấp."
"[english]DOTA_nemestice_gameplay_tip_00"	"When a tower is destroyed, all remaining allied towers will be upgraded."
"DOTA_nemestice_gameplay_tip_20"	"Khi trụ bị phá hủy, nó giải phóng một xung lực diệt toàn bộ quái phe địch ở gần."
"[english]DOTA_nemestice_gameplay_tip_20"	"When a tower is destroyed, it releases a shockwave that kills all nearby enemy creeps."
"DOTA_nemestice_gameplay_tip_21"	"Khi trụ bị phá hủy, các trụ đồng minh khác được phục hồi một lượng lớn phần trăm máu."
"[english]DOTA_nemestice_gameplay_tip_21"	"When a tower is destroyed, other allied towers are healed for a large percentage of their health."
"DOTA_nemestice_gameplay_tip_22"	"Thời gian hồi Glyph of Fortification được làm mới mỗi khi một trụ của bạn bị phá hủy."
"[english]DOTA_nemestice_gameplay_tip_22"	"The Glyph of Fortification cooldown is refreshed each time you lose a tower."
"DOTA_nemestice_gameplay_tip_23"	"Mỗi Nemestice Ember có hạn dùng riêng."
"[english]DOTA_nemestice_gameplay_tip_23"	"Each Nemestice Ember has its own independent expiration time."
"DOTA_nemestice_gameplay_tip_24"	"Embercharge cho bạn sức đánh, cường hóa phép, và tốc độ chạy. Từ ba Embercharge trở lên và bạn sẽ thậm chí giật điện đối phương gần đó."
"[english]DOTA_nemestice_gameplay_tip_24"	"Embercharge gives you attack damage, spell amplification, and move speed. It also grants a shocking ability at three or more Embers."
"DOTA_HUD_Scoreboard_Nemestice_towers_name"	"TRỤ"
"[english]DOTA_HUD_Scoreboard_Nemestice_towers_name"	"TOWERS"
"DOTA_HUD_Scoreboard_Nemestice_upgrades_name"	"NÂNG CẤP"
"[english]DOTA_HUD_Scoreboard_Nemestice_upgrades_name"	"UPGRADES"
"DOTA_HUD_Scoreboard_Nemestice_tower_name_northwest"	"Trụ Tây Bắc"
"[english]DOTA_HUD_Scoreboard_Nemestice_tower_name_northwest"	"NW Tower"
"DOTA_HUD_Scoreboard_Nemestice_tower_name_north"	"Trụ Bắc"
"[english]DOTA_HUD_Scoreboard_Nemestice_tower_name_north"	"N Tower"
"DOTA_HUD_Scoreboard_Nemestice_tower_name_northeast"	"Trụ Đông Bắc"
"[english]DOTA_HUD_Scoreboard_Nemestice_tower_name_northeast"	"NE Tower"
"DOTA_HUD_Scoreboard_Nemestice_tower_name_east"	"Trụ Đông"
"[english]DOTA_HUD_Scoreboard_Nemestice_tower_name_east"	"E Tower"
"DOTA_HUD_Scoreboard_Nemestice_tower_name_west"	"Trụ Tây"
"[english]DOTA_HUD_Scoreboard_Nemestice_tower_name_west"	"W Tower"
"DOTA_HUD_Scoreboard_Nemestice_tower_name_southwest"	"Trụ Tây Nam"
"[english]DOTA_HUD_Scoreboard_Nemestice_tower_name_southwest"	"SW Tower"
"DOTA_HUD_Scoreboard_Nemestice_tower_name_south"	"Trụ Nam"
"[english]DOTA_HUD_Scoreboard_Nemestice_tower_name_south"	"S Tower"
"DOTA_HUD_Scoreboard_Nemestice_tower_name_southeast"	"Trụ Đông Nam"
"[english]DOTA_HUD_Scoreboard_Nemestice_tower_name_southeast"	"SE Tower"
"DOTA_Tooltip_modifier_hero_buy_phase_Description"	"Cấm đánh/Khóa phép/Cấm đồ khi bạn đang mua sắm!"
"[english]DOTA_Tooltip_modifier_hero_buy_phase_Description"	"Disarm/Silence/Mute while you shop!"
"npc_dota_nemestice_tower_radiant"	"Trụ Radiant"
"[english]npc_dota_nemestice_tower_radiant"	"Radiant Tower"
"npc_dota_nemestice_tower_dire"	"Trụ Dire"
"[english]npc_dota_nemestice_tower_dire"	"Dire Tower"
"npc_dota_nemestice_shrine"	"Giếng"
"[english]npc_dota_nemestice_shrine"	"Shrine"
"npc_dota_dummy_caster"	"Cuồng Nguyệt"
"[english]npc_dota_dummy_caster"	"The Mad Moon"
"npc_dota_creature_tower_upgrade_kobold"	"Kobold"
"[english]npc_dota_creature_tower_upgrade_kobold"	"Kobold"
"npc_dota_creature_tower_upgrade_hellbear"	"Gấu Địa Ngục"
"[english]npc_dota_creature_tower_upgrade_hellbear"	"Hellbear"
"npc_dota_creature_troll_priest"	"Mục Sư Cự Ma"
"[english]npc_dota_creature_troll_priest"	"Troll Priest"
"DOTA_Tooltip_ability_kobold_rush"	"Kobold Rush"
"[english]DOTA_Tooltip_ability_kobold_rush"	"Kobold Rush"
"DOTA_Tooltip_ability_kobold_rush_Description"	"Tăng thêm tốc độ chạy và đánh khi tấn công tướng."
"[english]DOTA_Tooltip_ability_kobold_rush_Description"	"Gains additional move and attack speed when attacking a hero."
"DOTA_Tooltip_ability_kobold_armor_reduction"	"Nghiền giáp"
"[english]DOTA_Tooltip_ability_kobold_armor_reduction"	"Shred Armor"
"DOTA_Tooltip_ability_kobold_armor_reduction_Description"	"Áp dụng bùa hại phá giáp, có thể cộng dồn, với mỗi đòn đánh cơ bản."
"[english]DOTA_Tooltip_ability_kobold_armor_reduction_Description"	"Applies a stacking minus armor debuff with each basic attack."
"DOTA_Tooltip_modifier_kobold_armor_reduction_counter"	"Giáp bị nghiền"
"[english]DOTA_Tooltip_modifier_kobold_armor_reduction_counter"	"Shredded Armor"
"DOTA_Tooltip_modifier_kobold_armor_reduction_counter_Description"	"Giáp giảm do bị Kobold tấn công liên tục."
"[english]DOTA_Tooltip_modifier_kobold_armor_reduction_counter_Description"	"Reduced armor from repeated Kobold attacks."
"npc_dota_crash_site_meteor"	"Thiên thạch Nemestice"
"[english]npc_dota_crash_site_meteor"	"Nemestice Meteorite"
"npc_dota_crash_site_meteor_medium"	"Thiên thạch Nemestice"
"[english]npc_dota_crash_site_meteor_medium"	"Nemestice Meteorite"
"DOTA_Tooltip_ability_item_meteor_shard"	"Nemestice Ember"
"[english]DOTA_Tooltip_ability_item_meteor_shard"	"Nemestice Ember"
"DOTA_Tooltip_modifier_hero_meteor_shard_pouch_buff"	"Embercharged"
"[english]DOTA_Tooltip_modifier_hero_meteor_shard_pouch_buff"	"Embercharged"
"DOTA_Tooltip_modifier_hero_meteor_shard_pouch_buff_Description"	"Tăng %dMODIFIER_PROPERTY_PREATTACK_BONUS_DAMAGE% sát thương đòn đánh, %dMODIFIER_PROPERTY_SPELL_AMPLIFY_PERCENTAGE%%% cường hóa phép, và %dMODIFIER_PROPERTY_MOVESPEED_BONUS_PERCENTAGE%%% tốc độ chạy."
"[english]DOTA_Tooltip_modifier_hero_meteor_shard_pouch_buff_Description"	"Gaining %dMODIFIER_PROPERTY_PREATTACK_BONUS_DAMAGE% bonus attack damage, %dMODIFIER_PROPERTY_SPELL_AMPLIFY_PERCENTAGE%%% spell amplification, and %dMODIFIER_PROPERTY_MOVESPEED_BONUS_PERCENTAGE%%% movement speed."
"DOTA_Tooltip_ability_tower_upgrade_spawn_lane_creeps"	"Tạo quái đường"
"[english]DOTA_Tooltip_ability_tower_upgrade_spawn_lane_creeps"	"Spawn Lane Creeps"
"DOTA_Tooltip_ability_tower_upgrade_spawn_lane_creeps_Description"	"Tạo %melee_spawns% quái cận chiến và %ranged_spawns% quái bắn xa với mỗi đợt từ trụ này."
"[english]DOTA_Tooltip_ability_tower_upgrade_spawn_lane_creeps_Description"	"Spawns %melee_spawns% Melee Creeps and %ranged_spawns% Ranged Creeps with each wave from this tower."
"DOTA_Tooltip_ability_tower_upgrade_spawn_melee_creeps"	"Tạo quái cận chiến"
"[english]DOTA_Tooltip_ability_tower_upgrade_spawn_melee_creeps"	"Spawn Melee Creeps"
"DOTA_Tooltip_ability_tower_upgrade_spawn_melee_creeps_Description"	"Tạo thêm %spawns% quái cận chiến với mỗi đợt từ trụ này."
"[english]DOTA_Tooltip_ability_tower_upgrade_spawn_melee_creeps_Description"	"Spawns %spawns% additional Melee Creeps with each wave from this tower."
"DOTA_Tooltip_ability_tower_upgrade_spawn_ranged_creeps"	"Tạo quái bắn xa"
"[english]DOTA_Tooltip_ability_tower_upgrade_spawn_ranged_creeps"	"Spawn Ranged Creeps"
"DOTA_Tooltip_ability_tower_upgrade_spawn_ranged_creeps_Description"	"Tạo thêm %spawns% quái bắn xa với mỗi đợt từ trụ này."
"[english]DOTA_Tooltip_ability_tower_upgrade_spawn_ranged_creeps_Description"	"Spawns %spawns% additional Ranged Creeps with each wave from this tower."
"DOTA_Tooltip_ability_tower_upgrade_add_lane_creeps"	"Thêm quái đường"
"[english]DOTA_Tooltip_ability_tower_upgrade_add_lane_creeps"	"Add Lane Creeps"
"DOTA_Tooltip_ability_tower_upgrade_add_lane_creeps_Description"	"Thêm một quái cận chiến hoặc bắn xa với mỗi đợt của trụ này. Cứ mỗi 4 lần nâng cấp thì cho một quái bắn xa. \n\nTối đa thêm 20 quái cho mỗi trụ."
"[english]DOTA_Tooltip_ability_tower_upgrade_add_lane_creeps_Description"	"Spawns an additional melee or ranged creep with this tower's creep wave.  Every 4th upgrade level is a ranged creep.  \n\nA maximum of 20 creeps can be added to each tower."
"DOTA_Tooltip_ability_tower_upgrade_spawn_hellbears"	"Tạo Gấu Địa Ngục"
"[english]DOTA_Tooltip_ability_tower_upgrade_spawn_hellbears"	"Spawn Hellbears"
"DOTA_Tooltip_ability_tower_upgrade_spawn_hellbears_Description"	"Tạo %spawns% Gấu Địa Ngục cuồng điên có đòn đánh khu vực với mỗi đợt từ trụ này."
"[english]DOTA_Tooltip_ability_tower_upgrade_spawn_hellbears_Description"	"Spawns %spawns% Raging Hellbears that use an area of effect smash attack with each wave from this tower."
"DOTA_Tooltip_ability_tower_upgrade_spawn_kobolds"	"Tạo Kobold"
"[english]DOTA_Tooltip_ability_tower_upgrade_spawn_kobolds"	"Spawn Kobolds"
"DOTA_Tooltip_ability_tower_upgrade_spawn_kobolds_Description"	"Tạo %spawns% Kobold tấn công với mỗi đợt từ trụ này."
"[english]DOTA_Tooltip_ability_tower_upgrade_spawn_kobolds_Description"	"Spawns %spawns% Kobolds that attack with each wave from this tower."
"DOTA_Tooltip_ability_tower_upgrade_spawn_troll_priests"	"Tạo Mục Sư Cự Ma"
"[english]DOTA_Tooltip_ability_tower_upgrade_spawn_troll_priests"	"Spawn Troll Priests"
"DOTA_Tooltip_ability_tower_upgrade_spawn_troll_priests_Description"	"Tạo %spawns% Mục Sư Cự Ma tấn công với mỗi đợt từ trụ này. Mục Sư có kỹ năng hồi máu."
"[english]DOTA_Tooltip_ability_tower_upgrade_spawn_troll_priests_Description"	"Spawns %spawns% Troll Priests that attack with each wave from this tower.  Troll Priests have a healing ability."
"DOTA_Tooltip_ability_tower_upgrade_tower_shrine"	"Giếng"
"[english]DOTA_Tooltip_ability_tower_upgrade_tower_shrine"	"Shrine"
"DOTA_Tooltip_ability_tower_upgrade_tower_shrine_Description"	"Kích hoạt giếng để tăng khả năng hồi máu và mana trong %duration% giây. \n\nKỹ năng này cứ 6 phút sẽ được cải thiện."
"[english]DOTA_Tooltip_ability_tower_upgrade_tower_shrine_Description"	"Activate the Shrine to provide increased health and mana regeneration for %duration% seconds. \n\nAbiliy automatically scales up every 6 minutes."
}
}
