"lang"
{
"Language"	"brazilian"
"Tokens"
{
"addon_game_name"	"Labirinto de Aghanim"
"[english]addon_game_name"	"Aghanim's Labyrinth"
"DOTA_GameMode_15"	"Labirinto de Aghanim"
"[english]DOTA_GameMode_15"	"Aghanim's Labyrinth"
"DOTA_GameMode_19"	"Labirinto de Aghanim"
"[english]DOTA_GameMode_19"	"Aghanim's Labyrinth"
"aghanim_bonus_round_time_left"	"TEMPO RESTANTE"
"[english]aghanim_bonus_round_time_left"	"TIME LEFT"
"aghanim_bonus_round_total_gold"	"Total de ouro"
"[english]aghanim_bonus_round_total_gold"	"Total Gold"
"DOTA_Defeated"	"A sua equipe foi derrotada!"
"[english]DOTA_Defeated"	"Your team has perished!"
"dota_game_end_victory_title_radiant"	"Vocês encontraram a saída do Labirinto de Aghanim!"
"[english]dota_game_end_victory_title_radiant"	"You have bested Aghanim's Labyrinth"
"dota_game_end_victory_title_dire"	"O seu grupo se perdeu no Labirinto de Aghanim"
"[english]dota_game_end_victory_title_dire"	"Aghanim's Labyrinth claims your party"
"DOTA_HUD_EnemiesRemaining"	"INIMIGOS RESTANTES:"
"[english]DOTA_HUD_EnemiesRemaining"	"ENEMIES REMAINING:"
"DOTA_HUD_TimeRemaining"	"TEMPO RESTANTE:"
"[english]DOTA_HUD_TimeRemaining"	"TIME REMAINING:"
"DOTA_HUD_Victory"	"VITÓRIA!"
"[english]DOTA_HUD_Victory"	"VICTORY!"
"DOTA_HUD_Defeat"	"DERROTA!"
"[english]DOTA_HUD_Defeat"	"DEFEAT!"
"DOTA_HUD_Kills"	"VÍTIMAS"
"[english]DOTA_HUD_Kills"	"KILLS"
"DOTA_HUD_Deaths"	"MORTES"
"[english]DOTA_HUD_Deaths"	"DEATHS"
"DOTA_HUD_Saves"	"AJUDOU"
"[english]DOTA_HUD_Saves"	"REVIVES"
"DOTA_HUD_Bags"	"BOLSAS"
"[english]DOTA_HUD_Bags"	"BAGS"
"DOTA_HUD_Mute"	"SILEN."
"[english]DOTA_HUD_Mute"	"MUTE"
"DOTA_HUD_PlayAgain"	"Jogar novamente?"
"[english]DOTA_HUD_PlayAgain"	"Play Again?"
"DOTA_HUD_Yes"	"SIM"
"[english]DOTA_HUD_Yes"	"YES"
"DOTA_HUD_No"	"NÃO"
"[english]DOTA_HUD_No"	"NO"
"DOTA_HUD_Score"	"PONTUAÇÃO"
"[english]DOTA_HUD_Score"	"SCORE"
"DOTA_HUD_GoldBags"	"BOLSAS DE OURO COLETADAS"
"[english]DOTA_HUD_GoldBags"	"GOLD BAGS COLLECTED"
"DOTA_HUD_GoldBagsMissed"	"BOLSAS PERDIDAS"
"[english]DOTA_HUD_GoldBagsMissed"	"GOLD BAGS MISSED"
"DOTA_HUD_TeamDeaths"	"MORTES DA EQUIPE"
"[english]DOTA_HUD_TeamDeaths"	"TEAM DEATHS"
"DOTA_HUD_Rewards"	"FRAGMENTOS DE CETRO"
"[english]DOTA_HUD_Rewards"	"SCEPTER SHARDS"
"DOTA_HUD_Blessings"	"BÊNÇÃOS"
"[english]DOTA_HUD_Blessings"	"BLESSINGS"
"DOTA_HUD_RoomRewards"	"Recomp. da sala"
"[english]DOTA_HUD_RoomRewards"	"Room Rewards"
"DOTA_HUD_ShowBlessings"	"Exibir bênçãos"
"[english]DOTA_HUD_ShowBlessings"	"Show Blessings"
"DOTA_HUD_HideBlessings"	"Ocultar bênçãos"
"[english]DOTA_HUD_HideBlessings"	"Hide Blessings"
"DOTA_HUD_Reward_Header"	"Escolha a sua recompensa"
"[english]DOTA_HUD_Reward_Header"	"Choose your reward"
"DOTA_HUD_Reward_Gold"	"Ouro adicional"
"[english]DOTA_HUD_Reward_Gold"	"Bonus Gold"
"DOTA_HUD_Reward_Gold_desc"	"{d:quantity} de ouro"
"[english]DOTA_HUD_Reward_Gold_desc"	"{d:quantity} Gold"
"DOTA_HUD_Reward_ExtraLives"	"Vida(s) extra"
"[english]DOTA_HUD_Reward_ExtraLives"	"Extra Live(s)"
"DOTA_HUD_Reward_ExtraLives_desc"	"{d:quantity} vida(s) extra"
"[english]DOTA_HUD_Reward_ExtraLives_desc"	"{d:quantity} Extra Life"
"DOTA_HUD_Reward_Item"	"Item neutro"
"[english]DOTA_HUD_Reward_Item"	"Neutral Item"
"DOTA_HUD_Reward_TempBuff"	"Bônus temp."
"[english]DOTA_HUD_Reward_TempBuff"	"Temp Buff"
"DOTA_HUD_Reward_Aura"	"Aura"
"[english]DOTA_HUD_Reward_Aura"	"Aura"
"DOTA_HUD_Reward_AbilityUpgrade"	"Bênção de Aghanim"
"[english]DOTA_HUD_Reward_AbilityUpgrade"	"Aghanim's Blessing"
"DOTA_HUD_Reward_MinotrAbilityUpgrade"	"Aprimoramento de habilidade"
"[english]DOTA_HUD_Reward_MinotrAbilityUpgrade"	"Ability Upgrade"
"DOTA_HUD_Reward_AdditionalRewards"	"Recompensas adicionais"
"[english]DOTA_HUD_Reward_AdditionalRewards"	"Additional Rewards Granted"
"DOTA_HUD_Game_Mode_Header"	"Bem-vindo(a) ao Labirinto de Aghanim!"
"[english]DOTA_HUD_Game_Mode_Header"	"Welcome To Aghanim's Labyrinth!"
"DOTA_HUD_Rewards_AscensionLevel"	"Dificuldade: {d:ascension_level}"
"[english]DOTA_HUD_Rewards_AscensionLevel"	"Ascension Level: {d:ascension_level}"
"DOTA_HUD_TopBar_Difficulty"	"{s:difficulty_name}"
"[english]DOTA_HUD_TopBar_Difficulty"	"{s:difficulty_name}"
"boss_shop"	"Bugigangas do Bristle"
"[english]boss_shop"	"Bristle's Baubles"
"DOTA_Subshop_1"	"Itens básicos"
"[english]DOTA_Subshop_1"	"Basics"
"DOTA_Subshop_2"	"Quinquilharias"
"[english]DOTA_Subshop_2"	"Trinkets"
"DOTA_HUD_BattleRoyaleDamageStarting"	"Não fuja da batalha, covarde!"
"[english]DOTA_HUD_BattleRoyaleDamageStarting"	"Join the battle, coward!"
"DOTA_Tooltip_Ability_item_battle_points"	"Pontos de batalha"
"[english]DOTA_Tooltip_Ability_item_battle_points"	"Battle Points"
"DOTA_Tooltip_Ability_item_arcane_fragments"	"Fragmentos Arcanos"
"[english]DOTA_Tooltip_Ability_item_arcane_fragments"	"Arcane Fragments"
"DOTA_RewardTooltip_Gold"	"Ouro"
"[english]DOTA_RewardTooltip_Gold"	"Gold"
"DOTA_RewardTooltip_XP"	"XP"
"[english]DOTA_RewardTooltip_XP"	"XP"
"DOTA_HUD_Rewards_ShowRewards"	"FRAGMENTO DO CETRO DISPONÍVEL"
"[english]DOTA_HUD_Rewards_ShowRewards"	"SCEPTER SHARD AVAILABLE"
"DOTA_HUD_Rewards_Info"	"Os aprimoramentos selecionados podem ser vistos no placar"
"[english]DOTA_HUD_Rewards_Info"	"View selected upgrades in the scoreboard"
"DOTA_Hud_EncounterDepth"	"Profundidade: {s:encounter_depth}"
"[english]DOTA_Hud_EncounterDepth"	"Depth {s:encounter_depth}"
"DOTA_Hud_AscenionAbilitiesTitle"	"Modificadores adicionais"
"[english]DOTA_Hud_AscenionAbilitiesTitle"	"Additional Modifiers"
"DOTA_Hud_Elite_Encounter_Discover"	"Confronto de elite — recompensas em dobro"
"[english]DOTA_Hud_Elite_Encounter_Discover"	"Elite Encounter - 2x Rewards"
"DOTA_Hud_Elite_Encounter"	"Confronto de elite"
"[english]DOTA_Hud_Elite_Encounter"	"Elite Encounter"
"DOTA_HUD_Reward_Rarity_Common"	"Escolha um fragmento <font color='#88A6D9'>COMUM</font>"
"[english]DOTA_HUD_Reward_Rarity_Common"	"Choose a <font color='#88A6D9'>COMMON</font> Scepter Shard"
"DOTA_HUD_Reward_Rarity_Elite"	"Escolha um fragmento de <font color='#D02B29'>ELITE</font>"
"[english]DOTA_HUD_Reward_Rarity_Elite"	"Choose an <font color='#D02B29'>ELITE</font> Scepter Shard"
"DOTA_HUD_Reward_Rarity_Epic"	"Escolha um fragmento <font color='#7266FF'>LENDÁRIO</font>"
"[english]DOTA_HUD_Reward_Rarity_Epic"	"Choose a <font color='#7266FF'>LEGENDARY</font> Scepter Shard"
"DOTA_HUD_REWARD_TYPE_GOLD_Toast"	"{s:player_name} escolheu {d:int_value} <panel class='CombatEventGoldIcon'/>"
"[english]DOTA_HUD_REWARD_TYPE_GOLD_Toast"	"{s:player_name} chose {d:int_value} <panel class='CombatEventGoldIcon'/>"
"DOTA_HUD_REWARD_TYPE_ITEM_Toast"	"{s:player_name} escolheu {s:locstring_value}"
"[english]DOTA_HUD_REWARD_TYPE_ITEM_Toast"	"{s:player_name} chose {s:locstring_value}"
"DOTA_HUD_REWARD_TYPE_ABILITY_UPGRADE_Toast"	"{s:player_name} escolheu {s:locstring_value}"
"[english]DOTA_HUD_REWARD_TYPE_ABILITY_UPGRADE_Toast"	"{s:player_name} chose {s:locstring_value}"
"DOTA_HUD_REWARD_TYPE_EXTRA_LIVES_Toast"	"{s:player_name} escolheu {d:int_value}"
"[english]DOTA_HUD_REWARD_TYPE_EXTRA_LIVES_Toast"	"{s:player_name} chose {d:int_value}"
"DOTA_HUD_REWARD_TYPE_MINOR_ABILITY_UPGRADE_Toast"	"{s:player_name} escolheu %s1"
"[english]DOTA_HUD_REWARD_TYPE_MINOR_ABILITY_UPGRADE_Toast"	"{s:player_name} chose %s1"
"DOTA_HUD_REWARD_TYPE_MINOR_STATS_UPGRADE_Toast"	"{s:player_name} escolheu %s1"
"[english]DOTA_HUD_REWARD_TYPE_MINOR_STATS_UPGRADE_Toast"	"{s:player_name} chose %s1"
"DOTA_HUD_REWARD_TYPE_GOLD_Desc"	"Ouro"
"[english]DOTA_HUD_REWARD_TYPE_GOLD_Desc"	"Gold"
"DOTA_HUD_REWARD_TYPE_TREASURE_Desc"	"Baú de Tesouro"
"[english]DOTA_HUD_REWARD_TYPE_TREASURE_Desc"	"Treasure Chest"
"DOTA_HUD_REWARD_TYPE_EXTRA_LIVES_Desc"	"Vidas adicionais"
"[english]DOTA_HUD_REWARD_TYPE_EXTRA_LIVES_Desc"	"Extra Lives"
"DOTA_HUD_Claimed_Rewards_Header"	"Recompensas resgatadas"
"[english]DOTA_HUD_Claimed_Rewards_Header"	"Claimed Rewards"
"DOTA_Hud_Tooltip_Outpost_Title"	"Combate"
"[english]DOTA_Hud_Tooltip_Outpost_Title"	"Combat"
"DOTA_Hud_Tooltip_Outpost_EliteTitle"	"Combate de elite"
"[english]DOTA_Hud_Tooltip_Outpost_EliteTitle"	"Elite Combat"
"DOTA_Hud_Tooltip_Outpost_TrapTitle"	"Armadilha"
"[english]DOTA_Hud_Tooltip_Outpost_TrapTitle"	"Trap"
"DOTA_Hud_Tooltip_Outpost_BossTitle"	"Chefão"
"[english]DOTA_Hud_Tooltip_Outpost_BossTitle"	"Boss"
"DOTA_Hud_Tooltip_Outpost_BonusTitle"	"Bônus"
"[english]DOTA_Hud_Tooltip_Outpost_BonusTitle"	"Bonus"
"DOTA_Hud_Tooltip_Outpost_TransitionTitle"	"Descanso"
"[english]DOTA_Hud_Tooltip_Outpost_TransitionTitle"	"Rest"
"DOTA_Hud_Outpost_ChannelBar_Title"	"Selecionando COMBATE"
"[english]DOTA_Hud_Outpost_ChannelBar_Title"	"Selecting COMBAT"
"DOTA_Hud_Outpost_ChannelBar_EliteTitle"	"Selecionando COMBATE DE <font color='#D02B29'>ELITE</font>"
"[english]DOTA_Hud_Outpost_ChannelBar_EliteTitle"	"Selecting <font color='#D02B29'>ELITE</font> COMBAT"
"DOTA_Hud_Outpost_ChannelBar_TrapTitle"	"Selecionando <font color='#FF7F37'>ARMADILHAS</font>"
"[english]DOTA_Hud_Outpost_ChannelBar_TrapTitle"	"Selecting <font color='#FF7F37'>TRAPS</font>"
"DOTA_Hud_Outpost_ChannelBar_BossTitle"	"Selecionando <font color='#7266FF'>CHEFÃO</font>"
"[english]DOTA_Hud_Outpost_ChannelBar_BossTitle"	"Selecting <font color='#7266FF'>BOSS</font>"
"DOTA_Hud_Outpost_ChannelBar_BonusTitle"	"Selecionando <font color='#f9cb4f'>BÔNUS</font>"
"[english]DOTA_Hud_Outpost_ChannelBar_BonusTitle"	"Selecting <font color='#f9cb4f'>BONUS</font>"
"DOTA_Hud_Outpost_ChannelBar_RestTitle"	"Selecionando <font color='#f9cb4f'>DESCANSO</font>"
"[english]DOTA_Hud_Outpost_ChannelBar_RestTitle"	"Selecting <font color='#f9cb4f'>REST</font>"
"defeat_all_enemies"	"Derrote todos os inimigos"
"[english]defeat_all_enemies"	"Defeat all enemies"
"survive_waves"	"Resista às ondas inimigas"
"[english]survive_waves"	"Survive enemy waves"
"destroy_spawning_portals"	"Destrua os portais sombrios"
"[english]destroy_spawning_portals"	"Destroy the Dark Portals"
"navigate_the_traps"	"Evite as armadilhas e chegue no objetivo"
"[english]navigate_the_traps"	"Navigate the Traps and Reach the Goal"
"kill_scarab_priests"	"Derrote os escaravelhos fanáticos"
"[english]kill_scarab_priests"	"Defeat the Scarab Priests"
"defeat_the_alchemists"	"Derrote os alquimistas"
"[english]defeat_the_alchemists"	"Defeat the Alchemists"
"defeat_boss_npc_dota_boss_void_spirit"	"Derrote a sombra de Inai"
"[english]defeat_boss_npc_dota_boss_void_spirit"	"Defeat the Shadow of Inai"
"defeat_boss_npc_dota_creature_temple_guardian"	"Derrote os guardiões do templo"
"[english]defeat_boss_npc_dota_creature_temple_guardian"	"Defeat the Temple Guardians"
"defeat_boss_npc_dota_creature_storegga"	"Derrote Storegga"
"[english]defeat_boss_npc_dota_creature_storegga"	"Defeat Storegga"
"defeat_boss_npc_dota_boss_aghanim"	"Derrote Aghanim"
"[english]defeat_boss_npc_dota_boss_aghanim"	"Defeat Aghanim"
"defeat_boss_npc_dota_boss_visage"	"Derrote o guardião do Labirinto Estreito"
"[english]defeat_boss_npc_dota_boss_visage"	"Defeat Warden of the Narrow Maze"
"defeat_boss_npc_dota_boss_timbersaw"	"Derrote Rizzrick Serranavalha"
"[english]defeat_boss_npc_dota_boss_timbersaw"	"Defeat Rizzrick the Razorsaw"
"kill_waveblasters"	"Derrote os morcegos explosivos"
"[english]kill_waveblasters"	"Defeat the Blaster Bats"
"kill_wildwings"	"Derrote os pássaros raivosos"
"[english]kill_wildwings"	"Defeat the Angry Birds"
"kill_tinies"	"Destrua amizades"
"[english]kill_tinies"	"Destroy Friendships"
"defeat_shadow_demons"	"Derrote os demônios das sombras"
"[english]defeat_shadow_demons"	"Defeat the Shadow Demons"
"rescue_sheep"	"Resgate as ovelhas"
"[english]rescue_sheep"	"Rescue the Sheep"
"save_gary"	"Proteja Gary"
"[english]save_gary"	"Protect Gary"
"destroy_all_mines"	"Destrua as minas submarinas"
"[english]destroy_all_mines"	"Destroy the Underwater Mines"
"defeat_shadow_shamans"	"Derrote os xamãs do pântano"
"[english]defeat_shadow_shamans"	"Defeat the Bog Shacklers"
"kill_shroom_giants"	"Derrote os cogumelos gigantes"
"[english]kill_shroom_giants"	"Defeat the Shroom Giants"
"objective_select_ascension_level"	"Selecione a dificuldade"
"[english]objective_select_ascension_level"	"Select Ascension Level"
"objective_stand_on_buttons"	"Fique em cima de um dos botões"
"[english]objective_stand_on_buttons"	"Stand On Starting Buttons"
"objective_select_aghanims_fragmants"	"Selecione os fragmentos do Cetro de Aghanim"
"[english]objective_select_aghanims_fragmants"	"Select Aghanim Scepter Shards"
"objective_saddle_up_on_morty"	"Monte em um dos Mortimus"
"[english]objective_saddle_up_on_morty"	"Saddle Up On Mortimus"
"objective_jump_to_collect_gold"	"Pule para coletar ouro!"
"[english]objective_jump_to_collect_gold"	"Jump To Collect Gold!"
"objective_saddle_up_on_penguin"	"Monte em um Peng-wing"
"[english]objective_saddle_up_on_penguin"	"Saddle Up On a Peng-Wing"
"objective_sled_to_collect_gold"	"Deslize para coletar ouro!"
"[english]objective_sled_to_collect_gold"	"Sled To Collect Gold!"
"defeat_blazhan"	"Derrote Rochama"
"[english]defeat_blazhan"	"Defeat Blazhan"
"defeat_frozhan"	"Derrote Rogelo"
"[english]defeat_frozhan"	"Defeat Frozhan"
"defeat_portly"	"Derrote Pudim"
"[english]defeat_portly"	"Defeat Portly"
"hint_ride_morty"	"{s:keybind} ou {s:alternate_keybind} para montar!"
"[english]hint_ride_morty"	"{s:keybind} or {s:alternate_keybind} to Saddle Up!"
"hint_hop_with_morty"	"Aponte o lagarto, aperte {s:keybind} uma vez para acumular energia e outra vez para pular!"
"[english]hint_hop_with_morty"	"Aim your lizard, then press {s:keybind} to gain power, and again to jump!"
"hint_ride_penguin"	"{s:keybind} ou {s:alternate_keybind} para montar!"
"[english]hint_ride_penguin"	"{s:keybind} or {s:alternate_keybind} to Saddle Up!"
"DOTA_Tooltip_modifier_aghsfort_firefly_burn"	"Piromaníaco"
"[english]DOTA_Tooltip_modifier_aghsfort_firefly_burn"	"Pyromaniac"
"DOTA_Tooltip_modifier_aghsfort_firefly_burn_Description"	"Você está em chamas."
"[english]DOTA_Tooltip_modifier_aghsfort_firefly_burn_Description"	"You are on fire."
"npc_dota_creature_brewmaster_boss"	"Mestre Panda"
"[english]npc_dota_creature_brewmaster_boss"	"Panda Bear Guy"
"npc_dota_brewmaster_earth_unit"	"Terço de Terra"
"[english]npc_dota_brewmaster_earth_unit"	"Earth Third"
"npc_dota_brewmaster_storm_unit"	"Terço de Tempestade"
"[english]npc_dota_brewmaster_storm_unit"	"Storm Third"
"npc_dota_brewmaster_fire_unit"	"Terço de Chamas"
"[english]npc_dota_brewmaster_fire_unit"	"Ember Third"
"npc_dota_creature_dire_hound"	"Lobinho Infernal"
"[english]npc_dota_creature_dire_hound"	"Dire Hound Cub"
"npc_dota_creature_dire_hound_boss"	"Lobo Infernal"
"[english]npc_dota_creature_dire_hound_boss"	"Dire Hound"
"npc_dota_creature_huskar"	"Guerreiro de Nothl"
"[english]npc_dota_creature_huskar"	"Nothl Warrior"
"npc_dota_creature_ogre_tank"	"Tanque dos Ossos"
"[english]npc_dota_creature_ogre_tank"	"Bonemeal Tank"
"npc_dota_creature_ogre_magi"	"Ogro dos Ossos"
"[english]npc_dota_creature_ogre_magi"	"Bonemeal Mage"
"npc_dota_creature_baby_ogre_tank"	"Tanquinho dos Ossos"
"[english]npc_dota_creature_baby_ogre_tank"	"Baby Bonemeal Tank"
"npc_dota_creature_baby_ogre_magi"	"Maguinho dos Ossos"
"[english]npc_dota_creature_baby_ogre_magi"	"Baby Bonemeal Mage"
"npc_dota_creature_small_hellbear"	"Urso Infernal Florestal"
"[english]npc_dota_creature_small_hellbear"	"Woodland Hellbear"
"npc_dota_creature_hellbear"	"Urso Infernal Guerreiro"
"[english]npc_dota_creature_hellbear"	"Hellbear Warrior"
"npc_dota_creature_rock_golem_a"	"Golem de Pedra Gigante"
"[english]npc_dota_creature_rock_golem_a"	"Giant Rock Golem"
"npc_dota_creature_luna_mini"	"Cavaleirinha da Lua"
"[english]npc_dota_creature_luna_mini"	"Tiny Moon Rider"
"npc_dota_creature_broodmother_baby"	"Miniaranhinha"
"[english]npc_dota_creature_broodmother_baby"	"Tiny Spiderling"
"npc_dota_creature_broodmother_baby_d"	"Aranhinha Peluda"
"[english]npc_dota_creature_broodmother_baby_d"	"Furry Spiderling"
"npc_dota_creature_pudge_miniboss"	"Pudim"
"[english]npc_dota_creature_pudge_miniboss"	"Portly"
"npc_dota_explosive_barrel"	"Barril Explosivo"
"[english]npc_dota_explosive_barrel"	"Explosive Barrel"
"npc_dota_creature_ice_roshan"	"Rogelo"
"[english]npc_dota_creature_ice_roshan"	"Frozhan"
"npc_dota_creature_fire_roshan"	"Rochama"
"[english]npc_dota_creature_fire_roshan"	"Blazhan"
"npc_dota_boss_aghanim"	"Aghanim, o Mago Apogético"
"[english]npc_dota_boss_aghanim"	"Aghanim, the Apex Mage"
"npc_dota_boss_timbersaw"	"Rizzrick"
"[english]npc_dota_boss_timbersaw"	"Rizzrick"
"DOTA_Chat_Tombstone_Pinged"	"Aliado falecido aqui!"
"[english]DOTA_Chat_Tombstone_Pinged"	"Fallen teammate here."
"DOTA_Tooltip_ability_item_satanic_bonus_damage"	"+$damage"
"[english]DOTA_Tooltip_ability_item_satanic_bonus_damage"	"+$damage"
"DOTA_Tooltip_Ability_aghanim_empty_spell1"	"Habilidade travada"
"[english]DOTA_Tooltip_Ability_aghanim_empty_spell1"	"Ability Locked"
"DOTA_Tooltip_Ability_aghanim_empty_spell2"	"Habilidade travada"
"[english]DOTA_Tooltip_Ability_aghanim_empty_spell2"	"Ability Locked"
"DOTA_Tooltip_Ability_aghanim_empty_spell3"	"Habilidade travada"
"[english]DOTA_Tooltip_Ability_aghanim_empty_spell3"	"Ability Locked"
"DOTA_Tooltip_Ability_aghanim_empty_spell4"	"Habilidade travada"
"[english]DOTA_Tooltip_Ability_aghanim_empty_spell4"	"Ability Locked"
"DOTA_Tooltip_modifier_aghanim_spell_swap"	"Habilidade travada"
"[english]DOTA_Tooltip_modifier_aghanim_spell_swap"	"Ability Locked"
"DOTA_Tooltip_Ability_item_spell_amp_potion"	"Poção de Amplificação Arcana"
"[english]DOTA_Tooltip_Ability_item_spell_amp_potion"	"Spell Amp Potion"
"DOTA_Tooltip_Ability_item_spell_amp_potion_Description"	"Concede %spell_amp_bonus_pct%%% de dano arcano adicional por %buff_duration% segundos.\n\nEm inglês: <b><font color='#F2A93E'>Spell Amp Potion</font></b>"
"[english]DOTA_Tooltip_Ability_item_spell_amp_potion_Description"	"Grants %spell_amp_bonus_pct%%% bonus spell damage for %buff_duration% seconds."
"DOTA_Tooltip_modifier_item_spell_amp_potion"	"Poção de Amplificação Arcana"
"[english]DOTA_Tooltip_modifier_item_spell_amp_potion"	"Spell Amp Potion"
"DOTA_Tooltip_modifier_item_spell_amp_potion_Description"	"Esta unidade tem 100 de amplificação arcana adicional."
"[english]DOTA_Tooltip_modifier_item_spell_amp_potion_Description"	"This unit has 100 bonus spell amp."
"DOTA_Tooltip_Ability_item_purification_potion"	"Poção Purificante"
"[english]DOTA_Tooltip_Ability_item_purification_potion"	"Purification Potion"
"DOTA_Tooltip_Ability_item_ravage_potion"	"Poção Devastadora"
"[english]DOTA_Tooltip_Ability_item_ravage_potion"	"Ravage Potion"
"DOTA_Tooltip_ability_item_ravage_potion_radius"	"RAIO:"
"[english]DOTA_Tooltip_ability_item_ravage_potion_radius"	"RADIUS:"
"DOTA_Tooltip_ability_item_ravage_potion_duration"	"DURAÇÃO:"
"[english]DOTA_Tooltip_ability_item_ravage_potion_duration"	"DURATION:"
"DOTA_Tooltip_ability_item_dragon_potion"	"Poção Draconiana"
"[english]DOTA_Tooltip_ability_item_dragon_potion"	"Dragon Potion"
"DOTA_Tooltip_ability_item_dragon_potion_Description"	"<h1>Usar: Forma de Dragão Ancestral</h1>Transforma-se em um dragão, ganhando Hálito Corrosivo, ataque/retardo em área e aumento de resistência mágica.\nEm inglês: <b><font color='#F2A93E'>Dragon Potion</font></b>"
"[english]DOTA_Tooltip_ability_item_dragon_potion_Description"	"<h1>Use: Elder Dragon Form</h1>Transform into a Dragon, gaining Corrosive Breath, Splash Damage/Slow, and increased Magic Resistance."
"DOTA_Tooltip_ability_item_dragon_potion_duration"	"DURAÇÃO:"
"[english]DOTA_Tooltip_ability_item_dragon_potion_duration"	"DURATION:"
"DOTA_Tooltip_ability_item_dragon_potion_bonus_movement_speed"	"VEL. DE MOV. ADICIONAL:"
"[english]DOTA_Tooltip_ability_item_dragon_potion_bonus_movement_speed"	"BONUS MOVE SPEED:"
"DOTA_Tooltip_ability_item_dragon_potion_bonus_attack_range"	"ALCANCE DE ATAQUE ADICIONAL:"
"[english]DOTA_Tooltip_ability_item_dragon_potion_bonus_attack_range"	"BONUS ATTACK RANGE:"
"DOTA_Tooltip_ability_item_dragon_potion_bonus_attack_damage"	"DANO ADICIONAL:"
"[english]DOTA_Tooltip_ability_item_dragon_potion_bonus_attack_damage"	"BONUS DAMAGE:"
"DOTA_Tooltip_ability_item_dragon_potion_magic_resistance"	"RESISTÊNCIA MÁGICA:"
"[english]DOTA_Tooltip_ability_item_dragon_potion_magic_resistance"	"MAGIC RESISTANCE:"
"DOTA_Tooltip_ability_item_dragon_potion_splash_radius"	"RAIO DE DANO:"
"[english]DOTA_Tooltip_ability_item_dragon_potion_splash_radius"	"SPLASH RADIUS:"
"DOTA_Tooltip_ability_item_dragon_potion_splash_damage_percent"	"PORCENTAGEM DE DANO EM ÁREA:"
"[english]DOTA_Tooltip_ability_item_dragon_potion_splash_damage_percent"	"SPLASH DAMAGE PERCENT:"
"DOTA_Tooltip_ability_item_arcanist_potion_duration"	"DURAÇÃO:"
"[english]DOTA_Tooltip_ability_item_arcanist_potion_duration"	"DURATION:"
"DOTA_Tooltip_Ability_item_echo_slam_potion"	"Poção Ecoante"
"[english]DOTA_Tooltip_Ability_item_echo_slam_potion"	"Echo Slam Potion"
"DOTA_Tooltip_ability_item_echo_slam_potion_echo_slam_echo_damage"	"DANO DO ECO:"
"[english]DOTA_Tooltip_ability_item_echo_slam_potion_echo_slam_echo_damage"	"ECHO DAMAGE:"
"DOTA_Tooltip_ability_item_echo_slam_potion_echo_slam_damage_range"	"RAIO:"
"[english]DOTA_Tooltip_ability_item_echo_slam_potion_echo_slam_damage_range"	"RADIUS:"
"DOTA_Tooltip_ability_item_echo_slam_potion_echo_slam_initial_damage"	"DANO INICIAL:"
"[english]DOTA_Tooltip_ability_item_echo_slam_potion_echo_slam_initial_damage"	"INITIAL DAMAGE:"
"DOTA_Tooltip_Ability_item_torrent_effect_potion"	"Poção da Torrente"
"[english]DOTA_Tooltip_Ability_item_torrent_effect_potion"	"Torrent Reflex"
"DOTA_Tooltip_ability_item_torrent_effect_potion_proc_chance"	"%CHANCE DE ATIVAÇÃO:"
"[english]DOTA_Tooltip_ability_item_torrent_effect_potion_proc_chance"	"%PROC CHANCE:"
"DOTA_Tooltip_ability_item_torrent_effect_potion_torrent_damage"	"DANO DA TORRENTE:"
"[english]DOTA_Tooltip_ability_item_torrent_effect_potion_torrent_damage"	"TORRENT DAMAGE:"
"DOTA_Tooltip_ability_item_torrent_effect_potion_stun_duration"	"DURAÇÃO DO ATORDOAMENTO:"
"[english]DOTA_Tooltip_ability_item_torrent_effect_potion_stun_duration"	"STUN DURATION:"
"DOTA_Tooltip_modifier_item_torrent_effect_potion"	"Poção da Torrente"
"[english]DOTA_Tooltip_modifier_item_torrent_effect_potion"	"Torrent Reflex"
"DOTA_Tooltip_modifier_item_torrent_effect_potion_Description"	"Esta unidade tem uma chance de ativar Torrentes ao ser atacada."
"[english]DOTA_Tooltip_modifier_item_torrent_effect_potion_Description"	"This unit has a chance to proc Torrent when attacked."
"DOTA_Tooltip_ability_item_shadow_wave_effect_potion"	"Poção da Onda Sombria"
"[english]DOTA_Tooltip_ability_item_shadow_wave_effect_potion"	"Shadow Wave Reflex"
"DOTA_Tooltip_ability_item_shadow_wave_effect_potion_Note1"	"Se os inimigos estiverem próximos a múltiplas unidades aliadas afetadas pela Onda Sombria, eles sofrerão múltiplas instâncias de dano."
"[english]DOTA_Tooltip_ability_item_shadow_wave_effect_potion_Note1"	"If enemies are near multiple allied units affected by Shadow Wave, they will take multiple instances of damage."
"DOTA_Tooltip_ability_item_shadow_wave_effect_potion_cast_range"	"ALCANCE:"
"[english]DOTA_Tooltip_ability_item_shadow_wave_effect_potion_cast_range"	"RANGE:"
"DOTA_Tooltip_modifier_aghsfort_shadow_wave_effect_potion"	"Poção da Onda Sombria"
"[english]DOTA_Tooltip_modifier_aghsfort_shadow_wave_effect_potion"	"Shadow Wave Reflex"
"DOTA_Tooltip_modifier_aghsfort_shadow_wave_effect_potion_Description"	"Esta unidade tem uma chance de ativar Ondas Sombrias ao ser atacada."
"[english]DOTA_Tooltip_modifier_aghsfort_shadow_wave_effect_potion_Description"	"This unit has a chance to proc Shadow Wave when attacked."
"DOTA_Tooltip_Ability_item_aghsfort_refresher_shard_Description"	"<h1>Usar: Zerar Intervalos</h1>Zera o intervalo entre usos de todos os seus itens e habilidades.\nEm inglês: <b><font color='#F2A93E'>Refresher Shard</font></b>"
"[english]DOTA_Tooltip_Ability_item_aghsfort_refresher_shard_Description"	"<h1>Use: Reset Cooldowns</h1>Resets the cooldowns of all your items and abilities."
"DOTA_Tooltip_modifier_ascension_attack_speed_Description"	"Mais %dMODIFIER_PROPERTY_ATTACKSPEED_BONUS_CONSTANT% de velocidade de ataque enquanto a vida estiver baixa."
"[english]DOTA_Tooltip_modifier_ascension_attack_speed_Description"	"Attack speed increased by %dMODIFIER_PROPERTY_ATTACKSPEED_BONUS_CONSTANT% while health is low."
"DOTA_Tooltip_modifier_ascension_chilling_touch"	"Toque Arrepiante"
"[english]DOTA_Tooltip_modifier_ascension_chilling_touch"	"Chilling Touch"
"DOTA_Tooltip_modifier_sand_king_boss_caustic_finale"	"Finalização Cáustica"
"[english]DOTA_Tooltip_modifier_sand_king_boss_caustic_finale"	"Caustic Finale"
"DOTA_Tooltip_ability_aghsfort_luna_lucent_beam_stun_duration"	"DURAÇÃO DO ATORDOAMENTO:"
"[english]DOTA_Tooltip_ability_aghsfort_luna_lucent_beam_stun_duration"	"STUN DURATION:"
"DOTA_Tooltip_ability_aghsfort_luna_eclipse_duration_tooltip"	"DURAÇÃO DO ECLIPSE:"
"[english]DOTA_Tooltip_ability_aghsfort_luna_eclipse_duration_tooltip"	"ECLIPSE DURATION:"
"DOTA_Tooltip_ability_aghsfort_luna_eclipse_duration_tooltip_scepter"	"DURAÇÃO (CETRO):"
"[english]DOTA_Tooltip_ability_aghsfort_luna_eclipse_duration_tooltip_scepter"	"SCEPTER DURATION:"
"DOTA_Tooltip_ability_aghsfort_luna_eclipse_cast_range_tooltip_scepter"	"ALCANCE DE USO (CETRO):"
"[english]DOTA_Tooltip_ability_aghsfort_luna_eclipse_cast_range_tooltip_scepter"	"SCEPTER CAST RANGE:"
"DOTA_Tooltip_ability_item_book_of_strength"	"Livro de Força"
"[english]DOTA_Tooltip_ability_item_book_of_strength"	"Book of Strength"
"DOTA_Tooltip_ability_item_book_of_agility"	"Livro de Agilidade"
"[english]DOTA_Tooltip_ability_item_book_of_agility"	"Book of Agility"
"DOTA_Tooltip_ability_item_book_of_intelligence"	"Livro de Inteligência"
"[english]DOTA_Tooltip_ability_item_book_of_intelligence"	"Book of Intelligence"
"DOTA_Tooltip_ability_item_book_of_greater_agility"	"Livro de Celeridade"
"[english]DOTA_Tooltip_ability_item_book_of_greater_agility"	"Book of Celerity"
"DOTA_Tooltip_Ability_item_keen_optic"	"Visor Keen"
"[english]DOTA_Tooltip_Ability_item_keen_optic"	"Keen Optic"
"DOTA_Tooltip_ability_item_unhallowed_icon_hp_regen"	"REGENERAÇÃO DE VIDA (AURA):"
"[english]DOTA_Tooltip_ability_item_unhallowed_icon_hp_regen"	"AURA HP REGEN:"
"DOTA_Tooltip_ability_item_preserved_skull_bonus_intelligence"	"INTELIGÊNCIA ADICIONAL:"
"[english]DOTA_Tooltip_ability_item_preserved_skull_bonus_intelligence"	"BONUS INTELLIGENCE:"
"DOTA_Tooltip_ability_item_treads_of_ermacor_bonus_movement_speed"	"VEL. DE MOV. ADICIONAL:"
"[english]DOTA_Tooltip_ability_item_treads_of_ermacor_bonus_movement_speed"	"BONUS MOVEMENT SPEED:"
"DOTA_Tooltip_ability_item_rhyziks_eye_hp_regen_sec"	"REGENERAÇÃO DE VIDA ADICIONAL:"
"[english]DOTA_Tooltip_ability_item_rhyziks_eye_hp_regen_sec"	"BONUS HP REGEN:"
"DOTA_Tooltip_ability_item_guardian_shell_magic_resistance"	"%RESISTÊNCIA MÁGICA ADICIONAL:"
"[english]DOTA_Tooltip_ability_item_guardian_shell_magic_resistance"	"%BONUS MAGIC RESISTANCE:"
"DOTA_Tooltip_ability_item_carapace_of_qaldin_damage_return_pct"	"%DANO REFLETIDO:"
"[english]DOTA_Tooltip_ability_item_carapace_of_qaldin_damage_return_pct"	"%DAMAGE RETURNED:"
"DOTA_Tooltip_ability_item_winter_embrace_bonus_intelligence"	"INTELIGÊNCIA ADICIONAL:"
"[english]DOTA_Tooltip_ability_item_winter_embrace_bonus_intelligence"	"BONUS INTELLIGENCE:"
"DOTA_Tooltip_ability_item_gravel_foot_bonus_movement_speed"	"VEL. DE MOV. ADICIONAL:"
"[english]DOTA_Tooltip_ability_item_gravel_foot_bonus_movement_speed"	"BONUS MOVEMENT SPEED:"
"DOTA_Tooltip_Ability_item_wand_of_the_brine_bonus_intelligence"	"+$int"
"[english]DOTA_Tooltip_Ability_item_wand_of_the_brine_bonus_intelligence"	"+$int"
"DOTA_Tooltip_Ability_item_slippers_of_the_abyss_bonus_movement_speed"	"VEL. DE MOV. ADICIONAL:"
"[english]DOTA_Tooltip_Ability_item_slippers_of_the_abyss_bonus_movement_speed"	"BONUS MOVEMENT SPEED:"
"DOTA_Tooltip_Ability_item_slippers_of_the_abyss_bonus_strength"	"+$str"
"[english]DOTA_Tooltip_Ability_item_slippers_of_the_abyss_bonus_strength"	"+$str"
"DOTA_Tooltip_Ability_item_slippers_of_the_abyss_bonus_agility"	"+$agi"
"[english]DOTA_Tooltip_Ability_item_slippers_of_the_abyss_bonus_agility"	"+$agi"
"DOTA_Tooltip_Ability_item_dredged_trident_bonus_damage"	"+$damage"
"[english]DOTA_Tooltip_Ability_item_dredged_trident_bonus_damage"	"+$damage"
"DOTA_Tooltip_Ability_item_lifestone_hp_regen"	"REGENERAÇÃO DE VIDA:"
"[english]DOTA_Tooltip_Ability_item_lifestone_hp_regen"	"HP REGEN:"
"DOTA_Tooltip_Ability_item_corrupting_blade_bonus_damage"	"+$damage"
"[english]DOTA_Tooltip_Ability_item_corrupting_blade_bonus_damage"	"+$damage"
"DOTA_Tooltip_ability_aghsfort_aura_reward_magic_resist_bonus_magical_armor"	"RESISTÊNCIA MÁGICA:"
"[english]DOTA_Tooltip_ability_aghsfort_aura_reward_magic_resist_bonus_magical_armor"	"MAGIC RESISTANCE:"
"DOTA_Tooltip_modifier_blessing_evasion_Description"	"Esquiva %dMODIFIER_PROPERTY_EVASION_CONSTANT%%% maior."
"[english]DOTA_Tooltip_modifier_blessing_evasion_Description"	"Providing %dMODIFIER_PROPERTY_EVASION_CONSTANT%%% evasion."
"DOTA_Tooltip_modifier_blessing_mana_boost"	"Bênção do Mana Máximo"
"[english]DOTA_Tooltip_modifier_blessing_mana_boost"	"Max Mana Blessing"
"DOTA_Tooltip_modifier_blessing_mana_boost_Description"	"Mana máximo %dMODIFIER_PROPERTY_EXTRA_MANA_PERCENTAGE%%% maior."
"[english]DOTA_Tooltip_modifier_blessing_mana_boost_Description"	"Providing %dMODIFIER_PROPERTY_EXTRA_MANA_PERCENTAGE%%% max mana."
"DOTA_Tooltip_modifier_blessing_health_boost"	"Bênção da Vida Máxima"
"[english]DOTA_Tooltip_modifier_blessing_health_boost"	"Max Health Blessing"
"DOTA_Tooltip_modifier_blessing_health_boost_Description"	"Vida máxima %dMODIFIER_PROPERTY_EXTRA_HEALTH_PERCENTAGE%%% maior."
"[english]DOTA_Tooltip_modifier_blessing_health_boost_Description"	"Providing %dMODIFIER_PROPERTY_EXTRA_HEALTH_PERCENTAGE%%% max health."
"DOTA_Tooltip_modifier_blessing_magic_resist"	"Bênção da Resistência Mágica"
"[english]DOTA_Tooltip_modifier_blessing_magic_resist"	"Magic Resist Blessing"
"DOTA_Tooltip_modifier_blessing_magic_resist_Description"	"Resistência mágica %dMODIFIER_PROPERTY_MAGICAL_RESISTANCE_BONUS%%% maior."
"[english]DOTA_Tooltip_modifier_blessing_magic_resist_Description"	"Providing %dMODIFIER_PROPERTY_MAGICAL_RESISTANCE_BONUS%%% magic resistance."
"DOTA_Tooltip_modifier_blessing_magic_damage_bonus"	"Bênção da Amplificação Arcana"
"[english]DOTA_Tooltip_modifier_blessing_magic_damage_bonus"	"Spell Amplification Blessing"
"DOTA_Tooltip_modifier_blessing_magic_damage_bonus_Description"	"Mais %dMODIFIER_PROPERTY_SPELL_AMPLIFY_PERCENTAGE%%% de amplificação arcana."
"[english]DOTA_Tooltip_modifier_blessing_magic_damage_bonus_Description"	"Providing %dMODIFIER_PROPERTY_SPELL_AMPLIFY_PERCENTAGE%%% spell amplification."
"DOTA_Tooltip_modifier_blessing_damage_bonus"	"Bênção do Dano Adicional"
"[english]DOTA_Tooltip_modifier_blessing_damage_bonus"	"Damage Bonus Blessing"
"DOTA_Tooltip_modifier_blessing_damage_bonus_Description"	"Mais %dMODIFIER_PROPERTY_PREATTACK_BONUS_DAMAGE% de dano de ataque (+%dMODIFIER_PROPERTY_TOOLTIP% por nível)."
"[english]DOTA_Tooltip_modifier_blessing_damage_bonus_Description"	"Providing %dMODIFIER_PROPERTY_PREATTACK_BONUS_DAMAGE% attack damage (+%dMODIFIER_PROPERTY_TOOLTIP% per level)."
"DOTA_Tooltip_modifier_blessing_movement_speed"	"Bênção da Velocidade de Movimento"
"[english]DOTA_Tooltip_modifier_blessing_movement_speed"	"Movement Speed Blessing"
"DOTA_Tooltip_modifier_blessing_movement_speed_Description"	"Mais %dMODIFIER_PROPERTY_MOVESPEED_BONUS_PERCENTAGE%%% de velocidade de movimento."
"[english]DOTA_Tooltip_modifier_blessing_movement_speed_Description"	"Providing %dMODIFIER_PROPERTY_MOVESPEED_BONUS_PERCENTAGE%%% movement speed."
"DOTA_Tooltip_modifier_blessing_damage_reflect"	"Reflexão de Dano"
"[english]DOTA_Tooltip_modifier_blessing_damage_reflect"	"Damage Reflection"
"DOTA_Tooltip_modifier_blessing_damage_reflect_Description"	"Refletindo %dMODIFIER_PROPERTY_TOOLTIP%%% do dano de volta ao atacante."
"[english]DOTA_Tooltip_modifier_blessing_damage_reflect_Description"	"Reflecting %dMODIFIER_PROPERTY_TOOLTIP%%% of damage back on the attacker."
"DOTA_Tooltip_modifier_blessing_spell_life_steal"	"Bênção do Roubo de Vida Mágico"
"[english]DOTA_Tooltip_modifier_blessing_spell_life_steal"	"Spell Life Steal Blessing"
"DOTA_Tooltip_modifier_blessing_spell_life_steal_Description"	"%dMODIFIER_PROPERTY_TOOLTIP%%% do dano arcano causado é retornado como vida."
"[english]DOTA_Tooltip_modifier_blessing_spell_life_steal_Description"	"%dMODIFIER_PROPERTY_TOOLTIP%%% of spell damage dealt is returned as health."
"DOTA_Tooltip_modifier_blessing_life_steal"	"Bênção do Roubo de Vida"
"[english]DOTA_Tooltip_modifier_blessing_life_steal"	"Life Steal Blessing"
"DOTA_Tooltip_modifier_blessing_life_steal_Description"	"%dMODIFIER_PROPERTY_TOOLTIP%%% do dano de ataque causado é retornado como vida."
"[english]DOTA_Tooltip_modifier_blessing_life_steal_Description"	"%dMODIFIER_PROPERTY_TOOLTIP%%% of attack damage dealt is returned as health."
"DOTA_Tooltip_modifier_blessing_potion_dragon"	"Bênção da Poção Draconiana"
"[english]DOTA_Tooltip_modifier_blessing_potion_dragon"	"Dragon Potion Blessing"
"DOTA_Tooltip_modifier_blessing_potion_dragon_Description"	"Agora, a Poção Draconiana transforma você em um Dragão Negro, aumentando o dano de ataque em %dMODIFIER_PROPERTY_TOOLTIP2% e o dano em área em %dMODIFIER_PROPERTY_TOOLTIP%%%."
"[english]DOTA_Tooltip_modifier_blessing_potion_dragon_Description"	"Dragon Potions now transform you into a Black Dragon, increasing attack damage by an additional %dMODIFIER_PROPERTY_TOOLTIP2% and splash damage by an additional %dMODIFIER_PROPERTY_TOOLTIP%%%."
"DOTA_Tooltip_modifier_blessing_potion_echo_slam"	"Bênção da Poção Ecoante"
"[english]DOTA_Tooltip_modifier_blessing_potion_echo_slam"	"Echo Slam Potion Blessing"
"DOTA_Tooltip_modifier_blessing_potion_echo_slam_Description"	"Poções Ecoantes causam mais %dMODIFIER_PROPERTY_TOOLTIP% de dano ecoante."
"[english]DOTA_Tooltip_modifier_blessing_potion_echo_slam_Description"	"Echo Slam Potions deal an additional %dMODIFIER_PROPERTY_TOOLTIP% echo damage."
"DOTA_Tooltip_modifier_blessing_potion_torrent"	"Bênção da Poção da Torrente"
"[english]DOTA_Tooltip_modifier_blessing_potion_torrent"	"Torrent Potion Blessing"
"DOTA_Tooltip_modifier_blessing_potion_torrent_Description"	"Poções da Torrente concedem uma chance adicional de %dMODIFIER_PROPERTY_TOOLTIP%%% de produzir uma torrente ao sofrer dano."
"[english]DOTA_Tooltip_modifier_blessing_potion_torrent_Description"	"Torrent Potions have an additional %dMODIFIER_PROPERTY_TOOLTIP%%% chance to produce a torrent when damaged."
"DOTA_Tooltip_modifier_blessing_potion_ravage"	"Bênção da Poção Devastadora"
"[english]DOTA_Tooltip_modifier_blessing_potion_ravage"	"Ravage Potion Blessing"
"DOTA_Tooltip_modifier_blessing_potion_ravage_Description"	"Poções Devastadoras atingem inimigos em um raio adicional de %dMODIFIER_PROPERTY_TOOLTIP% unidades."
"[english]DOTA_Tooltip_modifier_blessing_potion_ravage_Description"	"Ravage Potions hit enemies in an additional %dMODIFIER_PROPERTY_TOOLTIP% radius."
"DOTA_Tooltip_modifier_blessing_potion_shadow_wave"	"Bênção da Poção da Onda Sombria"
"[english]DOTA_Tooltip_modifier_blessing_potion_shadow_wave"	"Shadow Wave Potion Blessing"
"DOTA_Tooltip_modifier_blessing_potion_shadow_wave_Description"	"Poções da Onda Sombria curam aliados e causam dano a inimigos em um adicional de %dMODIFIER_PROPERTY_TOOLTIP%."
"[english]DOTA_Tooltip_modifier_blessing_potion_shadow_wave_Description"	"Shadow Wave Potions heal allies and damage enemies for an additional %dMODIFIER_PROPERTY_TOOLTIP%."
"DOTA_Tooltip_modifier_blessing_potion_purification"	"Bênção da Poção Purificante"
"[english]DOTA_Tooltip_modifier_blessing_potion_purification"	"Purification Potion Blessing"
"DOTA_Tooltip_modifier_blessing_potion_purification_Description"	"Poções Purificantes causam dano a inimigos em um raio adicional de %dMODIFIER_PROPERTY_TOOLTIP% unidades."
"[english]DOTA_Tooltip_modifier_blessing_potion_purification_Description"	"Purification Potions damage enemies in an additional %dMODIFIER_PROPERTY_TOOLTIP% radius."
"DOTA_Tooltip_modifier_blessing_respawn_time_reduction"	"Bênção do Renascimento Rápido"
"[english]DOTA_Tooltip_modifier_blessing_respawn_time_reduction"	"Respawn Time Reduction Blessing"
"DOTA_Tooltip_modifier_blessing_respawn_time_reduction_Description"	"Tempo para renascer %dMODIFIER_PROPERTY_TOOLTIP%%% menor."
"[english]DOTA_Tooltip_modifier_blessing_respawn_time_reduction_Description"	"Reducing respawn time by %dMODIFIER_PROPERTY_TOOLTIP%%%."
"DOTA_Tooltip_modifier_blessing_strength"	"Força adicional"
"[english]DOTA_Tooltip_modifier_blessing_strength"	"Strength Bonus"
}
}
